1 16 25
#########################
#p    fx       s bs 2f  #
# # # # # # #s#f#f# # # #
#   * 1x xs   x *     2 #
# #f#s# # # # # # #f# #b#
#  bx  f *   s  ff      #
# # # # # # #s# # # # # #
#  fbf f*    b          #
#x# # # #f# # # # # # # #
#       f       x       #
# # # #2#f# #s# # # # #f#
#  x *f fx  s1 s       2#
# # #1# # # #x# # # # # #
#     x   2 ss      s1 f#
#f# # # # #f# #f# # # # #
#########################

