1 19 22
######################
#p  s     x       x  #
# # # # # # #f# #s# ##
#    ff f  xx s f1   #
# # # # # # # # # #f##
# f      f  *  s  b* #
# #s# # # # #s# # # ##
#         fx  f      #
# # # # # # # # # #s##
# f f s     f       s#
# # #b# # # # # # # ##
# s f x  *       f   #
# # # #*# #x# # # #s##
#x     x f  x 2   fs #
# # # # # # # # # # ##
#       xf2 s   f    #
#*# # #2# # # # # # ##
#  fsf      s f f 2  #
######################

