1 17 22
######################
#p       ssf         #
# # # # # # # #x#*#s##
#    x    2   *x2    #
# # # #f#2# # #1# # ##
#   f   fss       2ss#
# # #*# # # #f# #x# ##
#x  2     s*     x   #
# # #s# #s# # # #2# ##
#     f         b    #
# # # # # #x# # #f#f##
# f  s        x x s  #
# #f# # # # # # # # ##
#      1  f   fx b   #
# # #1#x# # # # # # ##
# s       1         2#
######################

