1 18 26
##########################
#p      s    1  2        #
# # # # # # # # # #s# # ##
#f    b  x b     s    1 s#
# # # #x#2# #*# # # # #x##
#     s        b f    2  #
# # # # # # # #*# # # # ##
#x  f1   f         f  s2 #
#b# # # # # # # # # # #s##
#2   b fx              f #
#1# #f# # #*# #x#2# # # ##
#      f f       ff xf x*#
# # # # # # # #f# # # # ##
#        x  x f   *      #
# # # # # # # #s# # # # ##
#x f          f1 f   *   #
#s# # #x# # #f# # # #2# ##
##########################

