1 18 25
#########################
#p   f3     *       ss  #
# # #s# # # #f#s#f# # #b#
#      f   f  b x   s  3#
#s#f# # #s# #f#s# # # # #
#      x f   f      fs  #
# #b# #f# # # # # # # # #
#  *        3 f       x #
# # # # # # # # #f# #f# #
#    f f     x1f    ff *#
# # # # #2# # # # # # #2#
# x *   2   1 2 f  s  s #
#f# # # # # #*# # # #s#3#
# x  fs3f         3sf   #
# #f# # # # # # # # # #1#
#    1 f      x  s  3   #
# # #2# # # # #f# # # #x#
#########################

