1 17 25
#########################
#p*          bx  x     s#
# #*# # # # # # # # # # #
#     s f13x 2ff f 3   *#
#x#x# # #f# # # # # # # #
#      f f  x 1s        #
# # #f# # # #3# # # #s# #
#  *x *  1     b f      #
# # # # # #b# # #f# # # #
#  s 1  ff   x     3 s  #
# # # # #3# # # #3# # # #
#f1 x     3  ss         #
# #2# # # # #s#f# # # # #
#xxb   s     x    1f    #
# # # # # # #f# #x# # # #
#f       *   f f   1 f  #
#########################

