1 16 29
#############################
#p      x * 1    b  x  sxs  #
# # # # #s# # # # # # # #2# #
# x    x   1   f    sx  x   #
# # # #x# # # # # # # # # # #
#f  s         x f  2   s    #
# #f#x#x# # # # #*# # #f# # #
#    2  f    f b  1         #
# # # #s#1#b# #s# # # # # #x#
# xf  1 x          b   sff  #
# # # # # # # # #1# # #s# # #
#b b  1   f ff  sf x *    *x#
#1#b#f# # # # # # # # #x# # #
#x    1 *s  x s      x   f  #
#f# #*#2#*# # # # # #*#s# #2#
#############################

