1 15 22
######################
#p f     f f    *s   #
# # # #b# # # # #f# ##
# fx     b x  f   2 b#
#f# # #s# # # #x# # ##
# s x     s  b**     #
# # # #1# #x#x#f# # ##
#  s    f s 2  fs1   #
#x#f#1# # # #*# # #s##
#b*              f x #
# #s# #b# # # #x# # ##
#s  f x  x  3s  2   s#
#s# # # # # # #f# # ##
#       * f b    b x #
######################

