1 17 27
###########################
#p * * f    f1   fxf   3f1#
# # # # # # #s# # # # #*# #
#b s b   x1 33  s x**   s #
# # # #b#b# # # # #x# #*# #
#  f  s* f   b   f     f  #
# # # # # #b# #3# # # #3# #
#s        b    b   f  fx3 #
# # # # # #2# #x# # # # # #
#  s * 12   1   b  xf 2  1#
#f# # # # # # #2# # # # # #
#2s        b*     * f fxs #
#s#b# #1# # #x# # # # #s# #
#           s *   3  fb3 1#
# # # # # # #x# # #1# # #f#
#        f x        s 3   #
###########################

