0 5 31
###############################
#p    *   *   *       *   *  2#
# # # # # # # # # # # # # # # #
#       *   *   *  *    *     #
###############################